/------------\/------------\
|............||............|
|./--\./---\.||./---\./--\.|
|#|  |.|   |.||.|   |.|  |#|
|.`--'.`---'.`'.`---'.`--'.|
|..........................|
|./--\./\./------\./\./--\.|
|.`--'.||.`--\/--'.||.`--'.|
|......||....||....||......|
`----\.|`--\ || /--'|./----'
     |.|/--' `' `--\|.|     
     |.||          ||.|     
     |.|| /--==--\ ||.|     
-----'.`' |      | `'.`-----
      .   |      |   .      
-----\./\ |      | /\./-----
     |.|| `------' ||.|     
     |.||          ||.|     
     |.|| /------\ ||.|     
/----'.`' `--\/--' `'.`----\
|............||............|
|./--\./---\.||./---\./--\.|
|.`-\|.`---'.`'.`---'.|/-'.|
|#..||.......  .......||..#|
`-\.||./\./------\./\.||./-'
/-'.`'.||.`--\/--'.||.`'.`-\
|......||....||....||......|
|./----'`--\.||./--'`----\.|
|.`--------'.`'.`--------'.|
|..........................|
`--------------------------'