/---------------\
|               |
|---------  ----|
|    |          |
|--\ |          |
|--| | ---------|
|--' |          |
|    |          |
|    |-----\    |
|    |          |
| /--'     \    |
| |        |    |
| `--\-----'    |
|    |          |
|-\  `---\      |
|               |
`---------------'