/-------------\
|             |
|-\ /------ --|
|-' `\        |
|    | -------|
|\   |        |
|' /-'------- |
|  `-\        |
|----'  /--\  |
|       |--|  |
|----'  `--'  |
|             |
|             |
|-\   /--\    |
|        |    |
`-------------'