/------\/---------------\
|      ||               |
|----\ || /--------\    |
|    | ||               |
|--\ ' ||---\     /--\  |
|--|   ||---'     `--'  |
|--' \ ||               |
|    | ||  /------\     |
|    | ||  `------'     |
| /--' ||               |
|      ||--\      /--\  |
| `--\ ||--'      `--'  |
|    | ||               |
|----' `'-\ /----\ /----|
|                       |
`-----\  /--------------'
/-----'  `--------------\
|                       |
|    |     /----\       |
|    |     `----'       |
| /--'                  |
|               /----\  |
| `--\          `----'  |
|    |                  |
|    |                  |
`----'------------------'