/-------------------------------------------------------------------------\
|                                                                         |
|                                                                         |
|                 ----               ---      ---         -  ---          |
|                                                     --                  |
|                      ---       --               --       ---      ---   |
|                -----      ---      ---      ---      ---      ---       |
|   ----   ---                            ---                             |
|                                                                         |
`-------------------------------------------------------------------------'